╔══════════════════════════════════════════════════╦═══╦══════════════════════════════════════════════════╗
║                                                  ║   ║                                                  ║
║                                                  ║   ║                                                  ║
║                                                  ║   ║                                                  ║
║     ╔═══════════════╗     ╔════════════════╗     ║   ║     ╔════════════════╗     ╔═══════════════╗     ║
║     ║               ║     ║                ║     ║   ║     ║                ║     ║               ║     ║
║     ╚═══════════════╝     ╚════════════════╝     ╚═══╝     ╚════════════════╝     ╚═══════════════╝     ║
║                                                                                                         ║
║                                                                                                         ║
║                                                                                                         ║
║     ╔═══════════════╗     ╔══╗     ╔═══════════════════════════════╗     ╔══╗     ╔═══════════════╗     ║
║     ╚═══════════════╝     ║  ║     ╚═════════════╗   ╔═════════════╝     ║  ║     ╚═══════════════╝     ║
║                           ║  ║                   ║   ║                   ║  ║                           ║
║                           ║  ║                   ║   ║                   ║  ║                           ║
║                           ║  ║                   ║   ║                   ║  ║                           ║
╚═════════════════════╗     ║  ╚═════════════╗     ║   ║     ╔═════════════╝  ║     ╔═════════════════════╝
╔══════╗╔═════╗╔═════╗║     ║  ╔═════════════╝     ╚═══╝     ╚═════════════╗  ║     ║╔═╗  ╔═╗╔═════╗╔═╗ ╔═╗
║   ═  ║║  ═  ║║  ╔══╝║     ║  ║                                           ║  ║     ║║ ╚╗╔╝ ║║  ═  ║║ ╚╗╣ ║
║  ╔═══╝║ ╔═╗ ║║  ╚══╗║     ║  ║                                           ║  ║     ║║ ╠╚╝╣ ║║ ╔═╗ ║║ ╠╚╗ ║
╚══╝    ╚═╝ ╚═╝╚═════╝║     ║  ║                                           ║  ║     ║╚═╝  ╚═╝╚═╝ ╚═╝╚═╝ ╚═╝
 ═════════════════════╝     ╚══╝     ╔════════════╗_____╔════════════╗     ╚══╝     ╚═════════════════════
                                     ║                               ║
                                     ║                               ║            
                                     ║                               ║           
 ═════════════════════╗     ╔══╗     ╚═══════════════════════════════╝     ╔══╗     ╔═════════════════════
                      ║     ║  ║                                           ║  ║     ║
                      ║     ║  ║                                           ║  ║     ║
                      ║     ║  ║                                           ║  ║     ║
                      ║     ║  ║     ╔═══════════════════════════════╗     ║  ║     ║
╔═════════════════════╝     ╚══╝     ╚═════════════╗   ╔═════════════╝     ╚══╝     ╚═════════════════════╗
║                                                  ║   ║                                                  ║
║                                                  ║   ║                                                  ║
║                                                  ║   ║                                                  ║
║     ╔═══════════════╗     ╔════════════════╗     ║   ║     ╔════════════════╗     ╔═══════════════╗     ║
║     ╚════════════╗  ║     ╚════════════════╝     ╚═══╝     ╚════════════════╝     ║  ╔════════════╝     ║
║                  ║  ║                                                             ║  ║                  ║
║                  ║  ║                                                             ║  ║                  ║
║                  ║  ║                                                             ║  ║                  ║
╠════════════╗     ║  ║     ╔══╗     ╔═══════════════════════════════╗     ╔══╗     ║  ║     ╔════════════╣
╠════════════╝     ╚══╝     ║  ║     ╚═════════════╗   ╔═════════════╝     ║  ║     ╚══╝     ╚════════════╣
║                           ║  ║                   ║   ║                   ║  ║                           ║
║                           ║  ║                   ║   ║                   ║  ║                           ║
║                           ║  ║                   ║   ║                   ║  ║                           ║
║     ╔═════════════════════╝  ╚═════════════╗     ║   ║     ╔═════════════╝  ╚═════════════════════╗     ║
║     ╚══════════════════════════════════════╝     ╚═══╝     ╚══════════════════════════════════════╝     ║
║                                                                                                         ║
║                                                                                                         ║
║                                                                                                         ║
╚═════════════════════════════════════════════════════════════════════════════════════════════════════════╝